00000000000000000000000000000000000000000
00000000000000000000000000000000000000000
00000000000000000000000000000000000000000
00000000000000000000000000000000000000000
00000000000000000000000000000000000000000
00000000000000002222222222222222222222222
00000000000000000000000000100000000000000
00000000000000000000000000000000000000000
00000000000000000000000000000000000000000
00000000000000000f00000000000000000000000