00000000000000000000000000000000000000000000000000000000000000000000000000000000000000000000000000000000000000000000000000000000000000000000000000000000000000000000000000000
00000000000000000000000000000000000000000000000000000000000000000000000000000000000000000000000000000000000000000000000000000000000000011000000001000000000010000000000000000
00000000000000000000000000000000000000000000000000000000000000000000000000000000000000000000000000000000000000000000000000000000000022222222222222222222222222220100000000000
00000000000000000000000000000000000000000000000000000000000000000000000000000000000000000000000000000000000000000000000000000002000020000000000000000000000000000201000000000
00000000000000000000000000000000000000000000000000000000000000000000000000000000000000000000000000000000000000000000000000200000000020000000000000000000000000000002000000000
00000000000000000000000000000000000000000000000000000000000000000000000000000000000000000000000000000000000000000000020000000000000020000000000000000000000000000000020111000
00000000000000000000000000000000000000000000000000000000000000000000000000000000000000000000000000000011000000002000000000000000000020000000000000000000000000000000000222222
00000000000000000000000000000000000000000000000200000000000000000000000000000000000000000100000000222222222200000000000000000000000020000000000000000000000000000000000000000
00000000000000000000000000000000000000000020000200000000000000000000000000000000000222222222222000222222222200000000000000000000000020000000000000000000000000000000000000000
00000000000000001000000000011000000112111121111200000000000000110000022221112222111222222222222111222222222211111111111111111111111120000000000000000000000000000000000000000